{
    "1001": "4",
    "1002": "4",
    "1003": "5",
    "1004": "5",
    "1005": "5",
    "1006": "5",
    "1008": "4",
    "1009": "4",
    "1013": "4",
    "1101": "5",
    "1102": "5",
    "1103": "4",
    "1104": "5",
    "1105": "4",
    "1106": "4",
    "1107": "5",
    "1108": "4",
    "1109": "4",
    "1110": "4",
    "1111": "4",
    "1112": "5",
    "1201": "4",
    "1202": "4",
    "1203": "5",
    "1204": "5",
    "1205": "5",
    "1206": "4",
    "1207": "4",
    "1208": "5",
    "1209": "5",
    "1210": "4",
    "1211": "5",
    "1212": "5",
    "1213": "5",
    "1214": "4",
    "1215": "4",
    "1217": "5",
    "1218": "5",
    "1220": "5",
    "1221": "5",
    "1222": "5",
    "1223": "4",
    "1224": "4",
    "1301": "4",
    "1302": "5",
    "1303": "5",
    "1304": "5",
    "1305": "5",
    "1306": "5",
    "1307": "5",
    "1308": "5",
    "1309": "5",
    "1310": "5",
    "1312": "4",
    "1314": "5",
    "1315": "5",
    "8001": "5",
    "8002": "5",
    "8003": "5",
    "8004": "5",
    "8005": "5",
    "8006": "5"
}