{
    "20000": 3,
    "20001": 3,
    "20002": 3,
    "20003": 3,
    "20004": 3,
    "20005": 3,
    "20006": 3,
    "20007": 3,
    "20008": 3,
    "20009": 3,
    "20010": 3,
    "20011": 3,
    "20012": 3,
    "20013": 3,
    "20014": 3,
    "20015": 3,
    "20016": 3,
    "20017": 3,
    "20018": 3,
    "20019": 3,
    "20020": 3,
    "21000": 4,
    "21001": 4,
    "21002": 4,
    "21003": 4,
    "21004": 4,
    "21005": 4,
    "21006": 4,
    "21007": 4,
    "21008": 4,
    "21009": 4,
    "21010": 4,
    "21011": 4,
    "21012": 4,
    "21013": 4,
    "21014": 4,
    "21015": 4,
    "21016": 4,
    "21017": 4,
    "21018": 4,
    "21019": 4,
    "21020": 4,
    "21021": 4,
    "21022": 4,
    "21023": 4,
    "21024": 4,
    "21025": 4,
    "21026": 4,
    "21027": 4,
    "21028": 4,
    "21029": 4,
    "21030": 4,
    "21031": 4,
    "21032": 4,
    "21033": 4,
    "21034": 4,
    "21035": 4,
    "21036": 4,
    "21037": 4,
    "21038": 4,
    "21039": 4,
    "21040": 4,
    "21041": 4,
    "21042": 4,
    "21043": 4,
    "21044": 4,
    "21045": 4,
    "21046": 4,
    "21047": 4,
    "22000": 4,
    "22001": 4,
    "22002": 4,
    "23000": 5,
    "23001": 5,
    "23002": 5,
    "23003": 5,
    "23004": 5,
    "23005": 5,
    "23006": 5,
    "23007": 5,
    "23008": 5,
    "23009": 5,
    "23010": 5,
    "23011": 5,
    "23012": 5,
    "23013": 5,
    "23014": 5,
    "23015": 5,
    "23016": 5,
    "23017": 5,
    "23018": 5,
    "23019": 5,
    "23020": 5,
    "23021": 5,
    "23022": 5,
    "23023": 5,
    "23024": 5,
    "23025": 5,
    "23026": 5,
    "23027": 5,
    "23028": 5,
    "23029": 5,
    "23030": 5,
    "23031": 5,
    "23032": 5,
    "24000": 5,
    "24001": 5,
    "24002": 5,
    "24003": 5,
    "24004": 5
}